XXXXXXXXXSXXTXOX
XOXXOXXX
XOOOOMOX
XXXXOXOX
XOXXOXOX
XOXXOXOX
XOXXOXOX
XOXXOXOX
XOXXOXOX
XOOOOXBX
XEXXXXXX
XXXXXXXX